###############
#A    #      B#
# ### # ##### #
#   # #     # #
### # ##### # #
#   #     #   #
# ####### ### #
#       #     #
# ##### ##### #
#     #       #
###############